FROM=to
NBR=ne haber
CNM=canim
SLM=selam
ABLEM=amblem
ACİTASYON=ajitasyon
ACENTA=acente
ADELE=adale
AC_GOZLU=acgozlu
AYIT=ait
AFILLI=afili
AF_ETMEK=affetmek
ABI=AGABEY
AGIRSIKLET=agır_sıklet
AKSAM_USTU=aksamustu
AK_CIGER=akciger
ANADIL=anadil
AHPAP=ahbap
AKAPUNKTUR=akupunktur
ALARIM=alarm
ANFI=amfi
ALIMINYUM=aliminyum
ANOTOMI=anatomi
ANTIPARANTEZ=antrparantez
ANTREMAN=antrenman
APARATIF=aparatif
APTES=abdest
ARABEKS=arabesk
AREFE=arife
ARTIZ=artist
ASKARI=asgari
ASSUBAY=astsubay
ASFALT=asfalt
ASENTIYON=esantiyon
aşofman=eşortman
ATAC=ataş
ATELYE=atölye
ATESE=atase
AVUT=aut
AHLAGA=ahlaka
BOLE=boyle
BIRARADA=bir arada
BIRHABER=bihaber
BIR_KAC= birkac
BILIR_KISI=bilirkisi
BARSAK=bagırsak
BILADER=birader
BILIMUM=bilumum
BIRFIIL=bilfiil
BOGAYILANI=boa yilani 
BOYPOS=boy bos 
BOACA=pogaca
PISKUVI=bisküvi
BIRSEY=bir sey
BIR_COK=bircok
DOKUMAN=doküman
DEF_OLMAK=defolmak
OLAGMAZ=olamaz
CAGRE=care
CUNKI=cunku
GURUP=grup
GRUB=grup
BIRAN=bir_an
BIRDEN_BIRE=birdenbire
BUYUK_BAS=buyukbas
CAN_KURTARAN=cankurtaran
ESPIRI=espri
EYLENCE=eglence
ESORTMAN=esofman
ESKIYA=eşkıya
ENTELLEKTUEL=entelektuel
ELEKTIRIK=elektrik
ESKI=eksi
ESSEK=esek
EGSOZ=egzoz
ETUD=etut
FANTAZI=fantezi
FULUT=flut
FARANJIT=farenjit
GARDOLAP=gardırop
FASULYE=fasulye
FILIM=film
FILORASAN=floresan
GRAVAT=kravat
GAZTE=gazete
KNK=kanka
FALIYET=faaliyet
GRSRZ=gorusuruz
EREZYON=erozyon
ESGAL=eskal
FIAT=fiyat
GIRAM=gram
GOZ_ALTI=gozaltı
HIRISTIYAN=hristiyan
HARFIYAT=hafriyat
IDDA=iddia
INSIYATIF=inisiyatif
HAFTASONU=hafta_sonu
HERKEZ=herkes
HIC_BIR=hicbir
HAZIR_CEVAP=hazircevap
HERSEY=her_şey
HALİSUNASYON=halusinasyon
IC_GUDU=icgudu
HERALDE=herhalde
HOSCAKAL=hosca_kal
ILKYARDIM=ilk_yardım
IZDUSUMSEL=iz_dusumsel
HAKKATEN=hakikaten
ILIZYON=illuzyon
IZALASYON=izolasyon
